#tileset
tileset2.bmp
8 11
tile0: mur
tile1: mur
tile2: mur
tile3: mur
tile4: mur
tile5: ciel
tile6: ciel
tile7: mur
tile8: mur
tile9: mur
tile10: mur
tile11: mur
tile12: mur
tile13: ciel
tile14: ciel
tile15: mur
tile16: mur
tile17: mur
tile18: mur
tile19: mur
tile20: ciel
tile21: ciel
tile22: ciel
tile23: ciel
tile24: mur
tile25: mort
tile26: mur
tile27: mur
tile28: mur
tile29: mur
tile30: mur
tile31: mur
tile32: mur
tile33: mur
tile34: mur
tile35: mur
tile36: mur
tile37: ciel
tile38: ciel
tile39: mur
tile40: mur
tile41: mur
tile42: mur
tile43: mur
tile44: ciel
tile45: ciel
tile46: ciel
tile47: ciel
tile48: mur
tile49: mur
tile50: mur
tile51: mur
tile52: mur
tile53: mur
tile54: mur
tile55: mur
tile56: mur
tile57: mur
tile58: mur
tile59: ciel
tile60: mort
tile61: ciel
tile62: mur
tile63: mur
tile64: mur
tile65: mur
tile66: mur
tile67: mur
tile68: mur
tile69: mur
tile70: mur
tile71: mur
tile72: mur
tile73: mur
tile74: mur
tile75: mur
tile76: mur
tile77: mur
tile78: mur
tile79: ciel
tile80: mur
tile81: ciel
tile82: ciel
tile83: mur
tile84: mur
tile85: mur
tile86: ciel
tile87: ciel
#level
155 19
49 	49 	49 	49	49 	49	49	49	49	49	49	49	49	49	49	49 	49 	49 	49 	49 	49 	49 	49 	49 	49 	49 	49 	49 	49	49 	49 	49 	49 	49 	49 	49 	49 	49	49 	49 	49 	49 	49 	49 	49 	49 	49	49 	49 	49 	49 	49 	49 	49 	49 	49	49 	49 	49 	49 	49 	49 	49 	49 	49	49 	49 	49 	49 	49 	49 	49 	49 	49	49 	49 	49 	49 	49 	49 	49 	49 	49	52	49 	49 	49	49	49	49	49	49	49	49	52	49	49	49	49	49	49	49	49	49	49	52	49	49	49	52	49	49	49	49	49	49	49	49	49	49	49	52	49	49	49	49	49	49	49	52	49	49	49	49	52	49	49	49	49	52	49	49	49	49	52	49	49	49	49	52	49	49	49	49	52
52	5 	5 	5 	5	5	5	5	5	5	5	5	5	5	5	5 	5 	5 	5 	52 	5 	5 	5 	5 	5 	5 	52 	5 	5 	5 	5 	5 	52 	5 	5 	5 	5 	52 	5 	5 	5 	5 	52 	5 	5 	5 	5 	5 	52 	5 	5 	5 	5 	5 	52 	5 	5 	5 	5 	5 	52 	5 	5 	5 	5 	5 	5 	5 	5 	5 	5 	5 	52 	5 	5 	52 	5 	5 	5 	5 	5 	5 	5 	52 	5 	5 	5 	5 	5 	5 	5 	5	5 	5 	49 	5 	5 	5 	5 	5 	5 	5 	5 	5	5	52	5	5 	5 	52	5 	5 	5 	5 	5 	5 	5 	5 	5 	5	5	5	5	5	5 	52 	5 	5 	5 	5 	5 	5 	5 	5 	49 	5 	5 	5 	5 	52	5 	5 	5 	5 	52	5 	5 	5 	5 	52	5 	5 	5 	5 	52
52 	5 	5 	5 	5	5	5	5	5	5	5	5	5	5	5	5 	5 	5 	5 	52 	5 	5 	5 	5 	5 	5 	52 	5 	5 	5 	5 	5 	52 	5 	5 	5 	5 	49 	5 	5 	5 	5 	52 	5 	5 	5 	5 	5 	52 	5 	5 	5 	5 	5 	52 	5 	5 	5 	5 	5 	52 	5 	5 	5 	5 	5 	5 	5 	5 	5 	5 	5 	49 	5 	5 	52 	5 	5 	5 	5 	5 	5 	5 	52 	5 	5 	5 	5 	5 	5 	5 	5 	5 	5 	5 	5 	5 	5 	5 	5 	5 	5 	5	5	5	52	5	5	5 	52	5 	5 	5 	5 	5 	5 	5 	5 	5 	5 	5 	5 	5 	5 	5 	52 	5 	5 	5 	5 	5 	5 	5 	5 	5 	5 	5 	5 	5 	52	5 	5 	5 	5 	52	5 	5 	5 	5 	52	5 	5 	5 	5 	52
52 	5 	5 	5 	5	5	5	5	5	5	5	5	5	5	5	5 	5 	5 	5 	52 	5 	5 	5 	5 	5 	5 	52 	5 	5 	5 	5 	5 	52 	5 	5 	5 	5 	5 	5 	5 	5 	5 	52 	5 	5 	5 	5 	5 	52 	5 	5 	5 	5 	5 	52 	5 	5 	5 	5 	5 	52 	5 	5 	5 	5 	5 	5 	5 	5 	5 	5 	5 	5 	5 	5 	52 	5 	5 	5 	5 	5 	5 	5 	52 	5 	5 	5 	5 	5 	5 	5 	5 	5 	5 	5 	5 	5 	5 	5 	5 	5 	5 	5	5	5	52	5	5	5 	52	5	5 	5 	5 	5 	5 	5 	5 	5 	5 	5 	5 	5 	5 	5 	48 	5 	5 	5 	5	5 	5 	5 	5 	5 	5 	5 	5 	5 	52	5 	5 	5 	5 	52	5 	5 	5 	5 	52	5 	5 	5 	5 	52
52 	5 	5 	5 	5	5	5	5	5	5	5	5	5	5	5	5 	5 	5 	5 	52 	5 	5 	5 	5 	5 	5 	49 	5 	5 	5 	5 	5 	52 	5 	5 	5 	5 	5 	5 	5 	5 	5 	52 	5 	5 	5 	5 	5 	52 	5 	5 	5 	5 	5 	52 	5 	5 	5 	5 	5 	52 	5 	5 	5 	5 	5 	5 	5 	5 	5 	5 	5 	5 	5 	5 	52 	5 	5 	5 	5 	5 	5 	5 	52 	5 	5 	5 	5 	5 	5 	5 	5 	5 	5 	5 	5 	5 	5 	5 	5 	5 	5 	5 	5	5	52	5	5	5 	52	5 	5 	5 	5	5	5	5	5	5	5 	5 	48 	5 	5 	5 	5	5 	5 	5 	48	5 	5 	5 	5 	5 	5 	5 	5 	5 	49	5 	5 	5 	5 	52	5 	5 	5 	5 	49 	5 	5 	5 	5 	52
52 	5 	5 	5 	5	5	5	5	5	5	5	5	5	5	5	5 	5 	5 	5 	52 	5 	5 	5 	5 	5 	5 	5 	5 	5 	5 	5 	5 	52 	5 	5 	5 	5 	5 	5 	5 	5 	5 	52 	5 	5 	5 	5 	5 	52 	5 	5 	5 	5 	5 	52 	5 	5 	5 	5 	5 	52 	5 	5 	5 	5 	5 	5 	5 	5 	48	5 	5 	5 	5 	5 	52 	5 	5 	5 	5 	5 	5 	5 	52 	5 	5 	5 	5 	5 	5 	5 	5 	5 	5 	5 	5 	5 	5 	5 	5 	5 	5 	5 	5	5	52	5	5	5 	52	5 	5 	5 	5 	5 	5 	5 	5 	5 	5 	5 	52	5 	5 	5 	5	5 	5 	5 	52 	5 	5 	5 	5 	5 	5 	5 	5 	5 	5 	5 	5 	5 	5 	52	5 	5 	5 	5 	5 	5 	5 	5 	5 	52
52 	5 	5 	5 	5	5	5	5	5	5	5	5	5	5	5	5 	5 	5 	5 	52 	5 	5 	5 	5 	5 	5 	5 	5 	5 	5 	5 	5 	52 	5 	5 	5 	5 	5 	5 	5 	5 	5 	52 	5 	5 	5 	5 	5 	52 	5 	5 	5 	5 	5 	52 	5 	5 	5 	5 	5 	49 	5 	5 	5 	5 	5 	5 	5 	5 	52 	5 	5 	5 	5 	5 	52 	5 	5 	5 	5 	5 	5 	5 	52 	5 	5 	5 	5 	5 	5 	5 	5 	5 	5 	48 	5 	5 	5 	5 	5 	5 	5 	5 	5	5	52	5	5	5 	52	5 	5	5	5 	5 	5 	5 	5 	5	5	5	52	5 	5 	5 	5	5 	5 	5 	52	5 	5 	5 	5 	5 	5 	5 	5 	5 	5 	5 	5 	5 	5 	52	5 	5 	5 	5 	5 	5 	5 	5 	5 	52
52 	5 	5 	5 	5	5	5	5	5	5	5	5	5	5	5	5 	5 	5 	5 	49 	5 	5 	5 	5 	5 	5 	5 	5 	5 	5 	5 	5 	49 	5 	5 	5 	5 	48 	5 	5 	5 	5 	52 	5 	5 	5 	5 	5 	49 	5 	5 	5 	5 	5 	52 	5 	5 	5 	5 	5 	5 	5 	5 	5 	5 	5 	5 	5 	5 	52 	5 	5 	5 	5 	5 	52 	5 	5 	5 	5 	5 	5 	5 	49 	5 	5 	5 	5 	5 	5 	5	5 	5 	5 	52 	5 	5 	5 	5 	5 	5 	5 	5 	5 	5 	52 	5 	5 	5 	52	6 	5 	5 	5 	5 	5 	5 	5 	5 	5 	5 	52	5	5	5 	5	5 	5 	5 	52	5 	5 	5 	5 	48	5 	5 	5 	5 	5 	5 	5 	5 	5 	49 	5 	5 	5 	5 	5 	5 	5 	5 	5 	52
52 	5 	5 	5 	5	5	5	5	5	5	5	5	5	5	5	5 	5 	5 	5 	5 	5 	5 	5 	5 	5 	5 	48 	5 	5 	5 	5 	5 	5 	5 	5 	5 	5 	52 	5 	5 	5 	5 	49 	5 	5 	5 	5 	5 	5 	5 	5 	5 	5 	5 	52 	5 	5 	5 	5 	5 	5 	5 	5 	5 	5 	5 	5 	5 	5 	52 	5 	5 	5 	5 	5 	52 	5 	5 	5 	5 	5 	5 	5 	5 	5 	5 	5	5 	5 	5 	5 	5	5 	5 	52 	5 	5 	5 	5 	5 	5 	5 	5 	5 	5 	52 	5 	5 	5 	52	5 	5 	5 	5 	5 	5 	5 	5 	5 	5 	5 	52	5 	5 	5 	5	5 	5 	5 	52	5 	5 	5	5 	52	5 	5 	5 	5 	5 	5 	5 	5 	5 	5 	5 	5 	5 	5 	5 	5 	5 	5 	5 	52
52 	5 	5 	5 	5	5	5	5	5	5	5	5	5	5	5	5 	5 	5 	5 	5 	5 	5 	5 	5 	5 	5 	52 	5 	5 	5 	5 	5 	5 	5 	5 	5 	5 	52 	5 	5 	5 	5 	5 	5 	5 	5 	5 	5 	5 	5 	5 	5 	5 	5 	52 	5 	5 	5 	5 	5 	5 	5 	5 	5 	5 	5 	5 	5 	5 	52 	5 	5 	5 	5 	5 	52 	5 	5 	5 	5 	5 	5 	5 	5	5 	5 	5 	5 	5 	5 	5 	5 	5 	5 	52 	5 	5 	5 	5 	5 	5 	5 	5 	5 	5 	52 	5 	5 	5 	52	5 	5 	5 	5	5	5 	5 	5 	5 	5 	5 	52	5 	5 	5 	5	5 	5 	5 	52	5 	5 	5	5 	52	5 	5 	5 	5 	5 	5 	5 	5 	5 	5 	5 	5 	5 	5 	5 	5 	5 	5 	5 	52
52 	5 	5 	5 	5	5	5	5	5	5	5	5	5	5	5	5 	5 	5 	5 	5 	5 	5 	5 	5 	5 	5 	52 	5 	5 	5 	5 	5 	5 	5 	5 	5 	5 	52 	5 	5 	5 	5 	5 	5 	5 	5 	5 	5 	5 	5 	5 	5 	5 	5 	49 	5 	5 	5 	5 	5 	5 	5 	5 	5 	5 	5 	5 	5 	5 	52 	5 	5 	5 	5 	5 	49 	5 	5 	5 	5	5 	5 	5 	5	5 	5 	5 	5 	5 	5 	5	5 	5 	5 	52 	5 	5 	5 	5 	5 	5 	5 	5 	5 	5 	52 	5 	5 	5 	52	5	5 	5 	5 	5 	5 	5 	5 	5 	5 	5 	52	5 	5 	5 	5	5 	5 	5 	52	5 	5 	5	5 	52	5 	5 	5 	5 	48 	5 	5 	5 	5 	5 	5 	5 	5 	5 	48 	5 	5 	5 	5 	52
52 	5 	5 	5 	5	5	5	5	5	5	5	5	5	5	5	5 	5 	5 	5 	5 	5 	5 	5 	5 	5 	5 	52 	5 	5 	5 	5 	5 	5 	5 	5 	5 	5 	52 	5 	5 	5 	5 	5 	5 	5 	5 	5 	5 	5 	5 	5 	5 	5 	5 	5 	5 	5 	5 	5 	5 	48 	5 	5 	5 	5 	5 	5 	5 	5 	52 	5 	5 	5 	5 	5 	5 	5 	5 	5 	5 	5 	5 	5 	5 	5 	5 	5 	5 	5 	5 	5 	5 	5 	5 	52 	5 	5 	5 	5 	5 	5 	5 	5 	5 	5 	52 	5 	5 	5 	52 	5 	5 	5 	5 	5 	5 	5 	5 	5 	5 	5 	52	5 	5 	5 	5	5 	5 	5 	52	5 	5 	5	5 	52	5 	5 	5 	5 	52 	5 	5 	5 	5 	5 	5 	5 	5 	5 	52	5 	5 	5 	5 	52
52 	5 	5 	5 	5	5	5	5	5	5	5	5	5	5	5	5 	5 	5 	5 	48 	5 	5 	5 	5 	5 	5 	52 	5 	5 	5 	5 	5 	48 	5 	5 	5 	5 	52 	5 	5 	5 	5 	5 	5 	5 	5 	5 	5 	48 	5 	5 	5 	5 	5 	5 	5 	5 	5 	5 	5 	52 	5 	5 	5 	5 	5 	5 	5 	5 	52 	5 	5 	5 	5 	5 	5 	5 	5 	5 	5 	5 	5 	5 	48 	5 	5 	5 	5 	5 	5 	5 	5	5 	5 	52 	5 	5 	5 	5 	5 	5 	5 	5 	5 	5 	49 	5 	5 	5 	49 	5 	5 	5 	5 	5 	5 	5 	5 	5 	5 	5 	52	5 	5 	5 	5	5 	5 	5 	52	5 	5 	5	5 	52	5 	5 	5 	5 	52	5 	5 	5 	5 	5 	5 	5 	5 	5 	52	5 	5 	5 	5 	52
52 	5 	5 	5 	5	5	5	5	5	5	5	5	5	5	5	5 	5 	5 	5 	52 	5 	5 	5 	5 	5 	5 	52 	5 	5 	5 	5 	5 	52 	5 	5 	5 	5 	52 	5 	5 	5 	5 	48 	5 	5 	5 	5 	5 	52 	5 	5 	5 	5 	5 	5 	5 	5 	5 	5 	5 	52 	5 	5 	5 	5 	5 	5 	5 	5 	52 	5 	5 	5 	5 	5 	5 	5 	5 	5 	48 	5 	5 	5 	52 	5 	5 	5 	5 	5 	5 	5 	5 	5 	5 	52 	5 	5 	5 	5 	5 	5 	5 	5 	5 	5 	5 	5 	5 	5	5 	5 	5 	5	5 	5 	5 	5 	5 	5 	5 	5 	52	5	5 	5 	5	5 	5 	5 	52	5 	5 	5	5 	52	5 	5 	5 	5 	52	5	5 	5 	5 	48 	5	5 	5 	5 	52	5 	5 	5 	5 	52
52 	5 	5 	5 	5	5	5	5	5	5	5	5	5	5	5	5 	5 	5 	5 	52 	5 	5 	5 	5 	5 	5 	52 	5 	5 	5 	5 	5 	52 	5 	5 	5 	5 	52 	5 	5 	5 	5 	52 	5 	5 	5 	5 	5 	52 	5 	5 	5 	5 	5 	5 	5 	5 	5 	5 	5 	52 	5 	5 	5 	5 	5 	5 	5 	5 	52 	5 	5 	5 	5 	5 	5 	5 	5 	5 	52 	5 	5 	5 	52 	5 	5 	5 	5 	5 	5 	5 	5	5 	5 	52 	5 	5 	5 	5 	5 	5 	5 	5 	5 	5 	5 	5 	5	5	5	5	5	5	5	5	5	5	5	5	5	5	52	5	5	5	5	5	5	5	52	5	5	5	5	52	5	5	5	5 	52	5	5	5	5	52	5	5	5	5 	52	5 	5 	5	5	52
52 	5 	5 	5 	5	5	5	5	5	5	5	5	5	5	5	5 	5 	5 	5 	52 	5 	5 	5 	5 	5 	5 	52 	5 	5 	5 	5 	5 	52 	5 	5 	5 	5 	52 	5 	5 	5 	5 	52	5 	5 	5 	5 	5 	52 	5 	5 	5 	5 	5 	48 	5 	5 	5 	5 	5 	52 	5 	5 	5 	5 	5 	5 	5 	5 	52 	5 	5 	5 	5 	5 	48 	5 	5 	5 	52 	5 	5 	5 	52 	5 	5 	5 	5 	5 	5 	5 	5 	5 	5 	52	5 	5 	5 	5 	5 	5 	5 	5 	5 	5	5	5 	5	5	5	5	5	5	5	5	5	5	5	5	5	5	52	5	5	5	5	5	5	5	52	5	5	5	5	52	5	5	5	5	52	5	5	5	5	52	5	5	5	5 	52	5 	5 	5 	5	52
52 	5 	5 	5 	5	5	5	5	5	5	5	5	5	5	5	5 	5 	5 	5 	52 	5 	5 	5 	5 	5 	5 	52 	5 	5 	5 	5 	5 	52 	5 	5 	5 	5 	52 	5 	5 	5 	5 	52 	5 	5 	5 	5 	5 	52 	5 	5 	5 	5 	5 	52 	5 	5 	5 	5 	5 	52 	5 	5 	5 	5 	5 	5 	5 	5 	52 	5 	5 	5 	5 	5 	52 	5 	5 	5 	52 	5 	5 	5 	52 	5 	5 	5	5 	5 	5 	5 	5	5 	5 	52 	5 	5 	5 	5 	5 	5 	5 	5 	5 	5	5	5 	5	5	5	5	5	5	5	5	5	5	5	5	5	5	52	5	5	5	5	5	5	5	52	5	5	5	5	52	5	5	5	5	52	5	5	5	5	52	5	5	5 	5 	52	5 	5 	5	5	52
52	5 	5 	5 	5	5	5	5	5	5	5	5	5	5	5	5 	5 	5 	5 	52 	5 	5 	5 	5 	5 	5 	52 	5 	5 	5 	5 	5 	52 	5 	5 	5 	5 	52 	5 	5 	5 	5 	52 	5 	5 	5 	5 	5 	52 	5 	5 	5 	5 	5 	52 	5 	5 	5 	5 	5 	52 	5 	5 	5 	5 	5 	5 	5 	5 	52 	5 	5 	5 	5 	5 	52 	5 	5 	5 	52 	5 	5 	5 	52 	5 	5 	5 	5 	5 	5 	5 	5	5 	5 	52	5	5 	5 	5 	5 	5 	5 	5 	5 	5	48	5 	5	5	48	5	5	5	5	5	5	5	5	5	5	5	52	5	5	5	5	5	5	5	52	5	5	5	5	52	5	5	5	5	52	5	5	5	5	52	5 	5	5	5 	52 	5 	5 	5 	5	52
48 	48 	48 	48 	48	48	48	48	48	48	48	48	48	48	48	48 	48 	48 	48 	48 	48 	48 	48 	48 	48 	48 	48 	48 	48	48 	48 	48 	48 	48 	48 	48 	48 	48	48 	48 	48 	48 	48 	48 	48 	48 	48	48 	48 	48 	48 	48 	48 	48 	48 	48	48 	48 	48 	48 	48 	48 	48 	48 	48	48 	48 	48 	48 	48 	48 	48 	48 	48	48 	52 	48 	48 	48 	48 	48 	48 	48	52	48	48 	48	48	48	48	48	48	48	48	52 	48	48	48	48	48	48	48	48	48 	48	52	48	48	48	52	48	48	48 	48	48	48	48	48	48	48	48	52 	48	48	48	48	48	48	48	52	48 	48	48	48	52	48	48	48	48	52 	48	48	48	48	52	48	48	48	48 	52	48	48	48	48	52
